6 6 4
5	0	0	0	0	2
0	0	0	0	0	0
0	2	0	0	3	0
0	4	0	0	0	0
0	3	0	0	4	5
0	0	0	0	0	0
