6 5 4
0	0	0	0	4
0	3	0	5	0
0	2	0	0	0
0	0	0	0	0
0	4	2	3	0
5	0	0	0	0
