6 6 5
2	0	0	0	0	6
0	4	5	6	4	0
0	0	0	0	0	0
0	5	0	0	0	0
0	0	0	0	3	0
3	0	0	0	2	0
