8 6 5
5	2	6	0	0	3
0	0	0	2	0	0
2	4	0	0	0	0
0	0	5	0	0	0
0	0	0	0	0	0
0	3	6	0	0	0
0	0	0	0	0	0
0	0	0	0	0	4
