5 5 4
4	0	0	0	0
0	3	4	5	0
0	0	0	0	0
2	5	0	0	3
0	0	0	0	2

