8 8 7
0	2	0	0	0	0	0	8
2	3	0	0	0	0	0	3
7	0	8	0	0	0	0	5
0	0	0	0	0	0	0	0
0	0	4	0	0	0	6	0
0	0	5	0	0	0	0	0
0	0	0	0	0	0	0	0
7	6	0	0	0	0	4	0

